#########################
# AStarEncoders class

AStarEncoders	KEYWORD1

flipDirection	KEYWORD2
getCountsLeft	KEYWORD2
getCountsRight	KEYWORD2
getCountsLeftAndReset	KEYWORD2
getCountsRightAndReset	KEYWORD2

#########################
# Odometer class

Odometer	KEYWORD1

getOmega	KEYWORD2
getPhi	KEYWORD2
getSpeed	KEYWORD2
getSpeedLeft	KEYWORD2
getSpeedRight	KEYWORD2
getTimeStep	KEYWORD2
getX	KEYWORD2
getY	KEYWORD2
reset	KEYWORD2
update	KEYWORD2
